cancel=Zrušit
add=Přidat
delete=Smazat
událost=Událost
ztlumit=ztlumit
noact=Zakázat akce
help=Nápověda
quit=Exit
flash=blesk
yearlist=Rok
settings=Nastavení
editevents=Upravit události
addevent=Přidat událost
notebook=Notebook
addpeople=Přidat lidi
addorganization=Přidat organizaci
fixace=fixace
zakázat=Zakázat
deleteafteruse=Smazat po použití
realtime=Pouze v
showmessage=Zobrazit zprávu
system=Systém
poweroff=Vypnutí
reboot=Restartovat
clockpanel=Velké hodiny
show=Ukázat
hide=Skrýt
shutdown=Vypnutí
p_oneshot=Jednou
p_hourly=Hodinově
p_daily=Denně
p_weekdays=Dny v týdnu
p_dayofmonth=Den
p_oneven=Zapnuto sudé
p_onuneven=Zapnuto nerovnoměrně
p_annually=Ročně
p_jubilee=Jubileum
p_days=Dny období
p_hours=Hodiny období
p_minutes=Minuty periody
p_monthly=Měsíční