cancel=Abbrechen
add=Hinzufügen
delete=Löschen
event=Ereignis
mute=Stumm
noact=Aktionen deaktivieren
help=Hilfe
quit=Beenden
flash=Blinken
yearlist=Jahr
settings=Einstellungen
editevents=Ereignisse bearbeiten
addevent=Ereignis hinzufügen
notebook=Notizbuch
addpeople=Personen hinzufügen
addorganization=Organisation hinzufügen
fixation=Fixierung
disable=Deaktivieren
deleteafteruse=Nach Verwendung löschen
realtime=Nur bei
showmessage=Nachricht anzeigen
system=System
poweroff=Ausschalten
reboot=Neustart
clockpanel=Große Uhr
show=Anzeigen
hide=Ausblenden
shutdown=Herunterfahren
p_oneshot=Einmalig
p_hourly=Stündlich
p_daily=Täglich
p_weekdays=Wochentage
p_dayofmonth=Tag
p_oneven=An geraden Tagen
p_onuneven=An ungerade
p_annually=Jährlich
p_jubilee=Jubiläum
p_days=Periodentage
p_hours=Periodenstunden
p_minutes=Periodenminuten
p_monthly=Monatlich