cancel=Ακύρωση
add=Προσθήκη
delete=Διαγραφή
συμβάν=Γεγονός
σίγαση=Σίγαση
noact=Απενεργοποίηση ενεργειών
βοήθεια=Βοήθεια
quit=Έξοδος
φλας=Φλας
yearlist=Έτος
ρυθμίσεις=Ρυθμίσεις
editents=Επεξεργασία συμβάντων
addevent=Προσθήκη συμβάντος
notebook=Τετράδιο
addpeople=Προσθήκη ατόμων
addorganization=Προσθήκη οργανισμού
fixation=Στερέωση
disable=Απενεργοποίηση
deleteafteruse=Διαγραφή μετά τη χρήση
πραγματικό χρόνο=Μόνο στις
showmessage=Εμφάνιση μηνύματος
σύστημα=Σύστημα
poweroff=Poweroff
reboot=Επανεκκίνηση
clockpanel=Μεγάλο ρολόι
εμφάνιση=Εμφάνιση
απόκρυψη=Απόκρυψη
shutdown=Τερματισμός
p_oneshot=Μια φορά
p_hourly=Ωριαία
p_daily=Καθημερινά
p_weekdays=Εβδομαδιαίες
p_dayofmonth=Ημέρα
p_oneven=Σε άρτιο
p_onuneven=Σε ανώμαλο
p_annually=Ετήσια
p_jubilee=Ιωβηλαίο
p_days=Ημέρες περιόδου
p_hours=Ώρες περιόδου
p_minutes=Περίοδος λεπτά
p_monthly=Μηνιαία