cancel=Cancel
add=Add
delete=Delete
event=Event
mute=Mute
noact=Disable actions
help=Help
quit=Exit
flash=Flash
yearlist=Year
settings=Settings
editevents=Edit events
addevent=Add event
notebook=Notebook
addpeople=Add people
addorganization=Add organization
fixation=Fixation
disable=Disable
deleteafteruse=Delete after use
realtime=Only at
showmessage=Show message
system=System
poweroff=Poweroff
reboot=Reboot
clockpanel=Big clock
show=Show
hide=Hide
shutdown=Shutdown
p_oneshot=One time
p_hourly=Hourly
p_daily=Daily
p_weekdays=Weekdays
p_dayofmonth=Day
p_oneven=On even
p_onuneven=On uneven
p_annually=Annually
p_jubilee=Jubilee
p_days=Period days
p_hours=Period hours
p_minutes=Period minutes
p_monthly=Monthly