cancel=Nuligi
aldoni=Aldoni
delete=Forigi
event=Okazajxo
mute=Mute
noact=Malŝalti agojn
help=Helpu
quit=Eliri
ekbrilo=Fulmi
jarlisto=Jaro
agordoj=Agordoj
editevents=Redakti eventojn
addevent=Aldoni eventon
notebook= Kajero
addpeople=Aldoni homojn
addorganization=Aldoni organizon
fixation=Fiksado
malebligi=Malŝalti
deleteafteruse=Forigi post uzo
realtime=Nur je
showmessage=Montri mesaĝon
system=Sistemo
poweroff=Malŝalti
reboot=Reboot
clockpanel=Granda horloĝo
montri=Montri
kaŝi=Kaŝi
shutdown=Ĉaltigu
p_oneshot=Unufoje
p_hourly=Hourly
p_daily=Ĉiutage
p_weekdays=Semajntagoj
p_dayofmonth=Tago
p_oneven=Evene
p_onuneven=Sur malebenaĵo
p_annually=Jare
p_jubilee=Jubileo
p_days=Periodaj tagoj
p_hours=Periopaj horoj
p_minutes=Periodaj minutoj
p_monthly=Monata