cancel=Cancelar
add=Agregar
delete=Eliminar
event=Evento
mute=Silenciar
noact=Deshabilitar acciones
help=Ayuda
quit=Salir
flash=Flash
yearlist=Año
settings=Configuración
editevents=Editar eventos
addevent=Agregar evento
notebook=Cuaderno de notas
addpeople=Agregar personas
addorganization=Agregar organización
fixation=Fijación
disable=Deshabilitar
deleteafteruse=Eliminar después uso
realtime=Tiempo real
showmessage=Mostrar mensaje
system=Sistema
poweroff=Apagar
reboot=Reiniciar
clockpanel=Reloj grande
show=Mostrar
hide=Ocultar
shutdown=Apagar
p_oneshot=Una sola vez
p_hourly=Cada hora
p_daily=Diariamente
p_weekdays=Días de la semana
p_dayofmonth=Día
p_oneven=En evento haz
p_onuneven=En no evento haz
p_annually=Anualmente
p_jubilee=Jubileo
p_days=Días
p_hours=Horas
p_minutes=Minutos
p_monthly=Mensual