cancel=Peruuta
add=Lisää
delete=Poista
tapahtuma=Tapahtuma
mykistys = Mykistys
noact=Poista toiminnot käytöstä
help=Apua
quit=Poistu
flash=Salama
vuosilista = Vuosi
settings=Asetukset
editevents=Muokkaa tapahtumia
addevent=Lisää tapahtuma
notebook=Muistikirja
addpeople=Lisää ihmisiä
addorganization=Lisää organisaatio
fixation=Kiinnitys
disable=Poista käytöstä
deleteafteruse=Poista käytön jälkeen
realtime=Vain klo
showmessage=Näytä viesti
system=Järjestelmä
poweroff=Pois päältä
reboot=Käynnistä uudelleen
clockpanel=Iso kello
show=Näytä
hide=Piilota
shutdown=Sammutus
p_oneshot=Kerran
p_hourly=Tunnin välein
p_daily=Päivittäin
p_weekdays=Arkipäivät
p_dayofmonth=Päivä
p_oneven=Päällä parillinen
p_onuneven=Epätasainen
p_annally = Vuosittain
p_jubilee=Jubilee
p_days = Jakson päivät
p_hours=Jakson tunnit
p_minutes=Jakson minuutit
p_monthly=Kuukausittain