cancel=Mégse
add=Hozzáadás
delete=Törlés
event=Esemény
néma=Némítás
noact=Műveletek letiltása
help=Súgó
quit=Kilépés
flash=Flash
yearlist=Év
settings=Beállítások
editevents=Események szerkesztése
addevent=Esemény hozzáadása
notebook=Jegyzetfüzet
addpeople=Személyek hozzáadása
addorganization=Szervezet hozzáadása
fixation=Rögzítés
disable=Letiltás
deleteafteruse=Használat után törlés
realtime=Csak at
showmessage=Üzenet megjelenítése
system=Rendszer
poweroff=Kikapcsolás
reboot=Újraindítás
clockpanel=Nagy óra
show=Megjelenítés
hide=Elrejtés
shutdown=Leállítás
p_oneshot=Egyszer
p_hourly=Óránként
p_daily=Napi
p_weekdays=Hétköznapok
p_dayofmonth=Nap
p_oneven=Be páros
p_onuneven=Egyenetlen
p_annally=Évente
p_jubilee=Jubileum
p_days=Időszaknapok
p_hours=Időszak óra
p_minutes=Időtartam perc
p_monthly=Havonta