cancel=Annulla
add=Aggiungi
delete=Elimina
event=Evento
mute=Disattiva audio
noact=Disabilita azioni
help=Aiuto
quit=Esci
flash=Flash
yearlist=Anno
settings=Impostazioni
editevents=Modifica eventi
addevent=Aggiungi evento
notebook=Notebook
addpeople=Aggiungi persone
addorganization=Aggiungi organizzazione
fixation=Fissazione
disable=Disabilita
deleteafteruse=Elimina dopo l'uso
realtime=Solo a
showmessage=Mostra messaggio
system=Sistema
poweroff=Spegni
reboot=Riavvia
clockpanel=Orologio grande
show=Mostra
hide=Nascondi
shutdown=Arresto
p_oneshot=Una volta
p_hourly=Ogni ora
p_daily=Giornaliero
p_weekdays=Giorni feriali
p_dayofmonth=Giorno
p_oneven=Pari
p_onuneven=Acceso irregolare
p_annually=Annualmente
p_jubilee=Giubileo
p_days=Giorni del periodo
p_hours=Ore del periodo
p_minutes=Minuti del periodo
p_monthly=Mensile