cancel=Annuleren
add=Toevoegen
delete=Verwijderen
event=Gebeurtenis
mute=Dempen
noact=Acties uitschakelen
help=Help
quit=Afsluiten
flash=Flash
yearlist=Jaar
settings=Instellingen
editevents=Gebeurtenissen bewerken
addevent=Gebeurtenis toevoegen
notebook=Notebook
addpeople=Personen toevoegen
addorganization=Organisatie toevoegen
fixation=Fixatie
disable=Uitschakelen
deleteafteruse=Verwijderen na gebruik
realtime=Alleen bij
showmessage=Bericht weergeven
system=Systeem
poweroff=Uitschakelen
reboot=Opnieuw opstarten
clockpanel=Grote klok
show=Tonen
hide=Verbergen
shutdown=Afsluiten
p_oneshot=Eenmalig
p_hourly=Per uur
p_daily=Dagelijks
p_weekdays=Weekdagen
p_dayofmonth=Dag
p_oneven=Aan even
p_onuneven=Aan oneven
p_annually=Jaarlijks
p_jubilee=Jubileum
p_days=Periodedagen
p_hours=Periodeuren
p_minutes=Periodeminuten
p_monthly=Maandelijks