cancel=Avbryt
add=Legg til
delete=Slett
event=Hendelse
mute=Mute
noact=Deaktiver handlinger
help=Hjelp
quit=Avslutt
flash=Blits
yearlist=År
settings=Innstillinger
editevents=Rediger hendelser
addevent=Legg til hendelse
notebook=Notatbok
addpeople=Legg til personer
addorganization=Legg til organisasjon
fiksering=Fiksering
disable=Deaktiver
deleteafteruse=Slett etter bruk
sanntid=Kun kl
showmessage=Vis melding
system=System
poweroff=Slå av
reboot=Start på nytt
clockpanel=Stor klokke
show=Vis
hide=Skjul
shutdown=Avslutt
p_oneshot=En gang
p_hourly=Hver time
p_daily=Daglig
p_weekdays=Ukedager
p_dayofmonth=Dag
p_oneven=På partall
p_onuneven=På ujevnt
p_annually=Årlig
p_jubilee=Jubileum
p_days=Periode dager
p_hours=Periode timer
p_minutes=Periode minutter
p_monthly=Månedlig