cancel=Cancelar
add=Adicionar
delete=Excluir
event=Evento
mute=Silenciar
noact=Desabilitar ações
help=Ajuda
quit=Sair
flash=Flash
yearlist=Ano
settings=Configurações
editevents=Editar eventos
addevent=Adicionar evento
notebook=Caderno
addpeople=Adicionar pessoas
addorganization=Adicionar organização
fixation=Fixação
disable=Desabilitar
deleteafteruse=Excluir após o uso
realtime=Somente em
showmessage=Mostrar mensagem
system=Sistema
poweroff=Desligar
reboot=Reiniciar
clockpanel=Relógio grande
show=Mostrar
hide=Ocultar
shutdown=Desligar
p_oneshot=Uma vez
p_hourly=De hora em hora
p_daily=Diariamente
p_weekdays=Dias da semana
p_dayofmonth=Dia
p_oneven=Ativado mesmo
p_onuneven=Ativado irregular
p_annually=Anualmente
p_jubilee=Jubileu
p_days=Dias do período
p_hours=Horas do período
p_minutes=Minutos do período
p_monthly=Mensalmente