cancel=Anulează
add=Adaugă
delete=Șterge
event=Eveniment
mute=Mute
noact=Dezactivați acțiuni
ajutor=Ajutor
ieșire=Ieșire
flash=Bliț
yearlist=Anul
settings=Setari
editevents=Editare evenimente
addevent=Adaugă eveniment
notebook=Caiet
addpeople=Adaugă persoane
addorganization=Adaugă organizaţie
fixation=Fixare
disable=Dezactivare
deleteafteruse=Șterge după utilizare
realtime=Numai la
showmessage=Afișează mesajul
system=Sistem
poweroff=Oprire
reboot=Reporniți
clockpanel=Ceas mare
show=Arată
hide=Ascunde
shutdown=Oprire
p_oneshot=O dată
p_hourly=Orear
p_daily=Zilnic
p_weekdays=Zilele săptămânii
p_dayofmonth=Ziua
p_oneven=Pe par
p_onuneven=Pe neuniform
p_annually=Anual
p_jubilee=Jubileu
p_days=Zile perioadei
p_hours=Perioada de ore
p_minutes=Perioada minute
p_monthly=Lunar