zrušiť=Zrušiť
add=Pridať
delete=Odstrániť
event=Udalosť
mute=Stlmiť
noact=Zakázať akcie
pomoc=Pomoc
quit=Exit
flash=blesk
yearlist=Rok
settings=Nastavenia
editevents=Upraviť udalosti
addevent=Pridať udalosť
notebook=Zápisník
addpeople=Pridať ľudí
addorganization=Pridať organizáciu
fixácia = fixácia
zakázať=Zakázať
deleteafteruse=Vymazať po použití
realtime=iba o
showmessage=Zobraziť správu
system=System
vypnutie = vypnutie
reboot=Reštartovať
clockpanel=Veľké hodiny
show=Zobraziť
skryť=Skryť
shutdown=Vypnutie
p_oneshot=Raz
p_hourly=Hodinový
p_daily=Denne
p_weekdays=Dni v týždni
p_dayofmonth=Deň
p_oneven=Na párne
p_onuneven=Na nerovnomernom
p_annually=Ročne
p_jubilee=Jubileum
p_days=Dni obdobia
p_hours=Hodiny obdobia
p_minutes=Minúty periódy
p_monthly=Mesačne