cancel=Avbryt
add=Lägg till
delete=Ta bort
händelse=Händelse
mute=Tyst
noact=Inaktivera åtgärder
hjälp=Hjälp
quit=Avsluta
flash=Blixt
årslista=År
settings=Inställningar
editevents=Redigera händelser
addevent=Lägg till händelse
notebook=Anteckningsbok
addpeople=Lägg till personer
addorganization=Lägg till organisation
fixation=Fixation
disable=Inaktivera
deleteafteruse=Ta bort efter användning
realtid=Endast kl
showmessage=Visa meddelande
system=System
poweroff=avstängning
reboot=Starta om
clockpanel=Stor klocka
show=Visa
hide=Göm
shutdown=Avstängning
p_oneshot=En gång
p_hourly=Varje timme
p_daily=Dagligen
p_weekdays=Vardagar
p_dayofmonth=Dag
p_oneven=På jämnt
p_onuneven=På ojämnt
p_annually=Årligen
p_jubilee=Jubileum
p_days=Period dagar
p_hours=Timmarsperiod
p_minutes=Period minuter
p_monthly=Månatlig