cancel=Скасувати
add=Додати
delete=Видалити
event=Подія
mute=Вимкнути звук
noact=Вимкнути дії
help=Допомога
quit=Вийти
flash=Флеш
yearlist=Рік
settings=Налаштування
editevents=Редагувати події
addevent=Додати подію
notebook=Записник
addpeople=Додати людей
addorganization=Додати організацію
fixation=Фіксація
disable=Вимкнути
deleteafteruse=Видалити після використання
realtime=тільки о
showmessage=Показати повідомлення
system=Система
poweroff=Вимкнути
reboot=Перезавантажити
clockpanel=Великий годинник
show=Показати
hide=Приховати
shutdown=Вимкнути
p_oneshot=Один раз
p_hourly=Щогодинно
p_daily=Щодня
p_weekdays=Будні
p_dayofmonth=День
p_oneven=На пари
p_onuneven=На нерівному
p_annually=Щорічно
p_jubilee=Ювілей
p_days=Дні періоду
p_hours=Години періоду
p_minutes=Хвилини періоду
p_monthly=Щомісяця